{
  "0": "爱",
  "1": "棒",
  "2": "饱",
  "3": "逼",
  "5": "勃",
  "6": "操",
  "8": "插",
  "9": "缠",
  "10": "潮",
  "11": "耻",
  "12": "抽",
  "13": "喘",
  "14": "床",
  "15": "春",
  "16": "唇",
  "17": "粗",
  "18": "搓",
  "19": "荡",
  "21": "洞",
  "23": "缝",
  "24": "帛",
  "25": "感",
  "26": "肛",
  "28": "根",
  "29": "宫",
  "30": "龟",
  "31": "棍",
  "32": "欢",
  "33": "激",
  "34": "鸡",
  "35": "妓",
  "37": "奸",
  "38": "交",
  "39": "禁",
  "40": "精",
  "41": "裤",
  "43": "浪",
  "44": "撩",
  "45": "流",
  "46": "露",
  "48": "乱",
  "49": "裸",
  "50": "满",
  "51": "毛",
  "52": "蜜",
  "53": "迷",
  "54": "敏",
  "55": "奶",
  "56": "嫩",
  "57": "尿",
  "58": "弄",
  "59": "虐",
  "60": "喷",
  "61": "屁",
  "62": "妻",
  "63": "枪",
  "64": "日",
  "65": "肉",
  "66": "揉",
  "67": "乳",
  "68": "蠕",
  "70": "塞",
  "71": "骚",
  "72": "色",
  "73": "射",
  "74": "湿",
  "75": "熟",
  "76": "爽",
  "77": "吮",
  "78": "舔",
  "79": "挺",
  "80": "吞",
  "81": "臀",
  "82": "脱",
  "83": "慰",
  "84": "吸",
  "85": "泄",
  "86": "邪",
  "87": "性",
  "88": "胸",
  "89": "穴",
  "90": "压",
  "91": "艳",
  "92": "阳",
  "93": "痒",
  "94": "腰",
  "95": "液",
  "97": "阴",
  "98": "淫",
  "99": "吟",
  "100": "迎",
  "101": "诱",
  "102": "欲",
  "103": "胀"
}
